EA textures/EAST.xpm 
NO textures/NORTH.xpm
C 128,198,165
F 111,2,5

WE textures/SOUTH.xpm
SO textures/SOUTH.xpm



          1111111111111111111111111
          1100000000011000000000001
          1011000001110000000000001
          1100100000000000000000011
111111111110000001110000000000001
100000000011000001110111111111111
11110111111111011100000010001
11110111111111011101010010001
11000000110101011100000010001
1000000000000N001100000010001
10000000000000011010100100001
11000001110101011111011110001
11110111 1110101 101111010001
11111111 1111111 111111111111