EA textures/EAST.png 
NO textures/NORTH.png
C 145,224,255
F 72,72,72

WE textures/WEST.png    
SO textures/SOUTH.png

 11
11111111111111
10000000000001
10000000000001
10000000000001
10000000000001
10000000000001
10000000000001
111111E1111111
      1