EA textures/EAST.png 
NO textures/NORTH.png
C 0,255,0
F 0,0,255

WE textures/SOUTH.png
SO textures/SOUTH.png



1111111111111111111111111
1100000000011000000000001
1011000001110000000000001
1100100000000000000000011
1111111111100000011100001
1111011111111101110000001
1111011111111101110101001
1100000011010011100000011
1000000000000N00110000001
1000000000000001101010011
1100000111010101111101111
1111011111110101110111101
1111111111111111111111111
